00000000000
02222222220
02002020200
02002020200
02222222220
02002000020
02222022220
02002020000
02222020111
02002220111
02222220111
02002020111
02222020000
02002022220
02222000020
02002222220
02222002020
02002002020
02222222220
00000000000