00000000000000000000
02222222222222222220
02002020202020020020
02002020202020022220
02222222222222220020
02002000022000022220
02222022222222020020
02002020000002022220
02222020111102020020
02002220111102222220
02222220111102220020
02002020111102022220
02222020000002020020
02002022222222022220
02222000022000020020
02002222222222222220
02222002020202020020
02002002020202020020
02222222222222222220
00000000000000000000