--------------------
-0*****************-
-*--*-*-*-*-*--*--*-
-*--*-*-*-*-*--****-
-***************--*-
-*--*----**----****-
-****-********-*--*-
-*--*-*------*-****-
-****-*-0000-*-*--*-
-*--***-0000-******-
-******-0000-***--*-
-*--*-*-0000-*-****-
-****-*------*-*--*-
-*--*-********-****-
-****----**----*--*-
-*--***************-
-****--*-*-*-*-*--*-
-*--*--*-*-*-*-*--*-
-******************-
--------------------