00000000000
02222222220
02002020200
02002020200
02222222220
02002000020
02222022220
02002020000
02222020111
02002220111
00000000000